NO ./textures/wall_4.png
SO ./textures/wall_3.png
WE ./textures/wall_1.png
EA ./textures/wall_2.png

F 10,0,18
C 11,0,40

111111111111111111111111111
100000000000000000000000001
10100000F000001000000000001
100000000000000000000000001
100010000000100000000000001
100000000000000000000000001
10101000N000101000000000001
100000000000000000000000001
100010001001000000000000001
100000000000000000000000001
101000001000010000000000001
100000000000000000000000001
100000000000000000000000001
100000000000000000000000001
100000000000000000000000001
100000000000000000000000001
100000000000000000000000001
100000000000000000000000001
100000000000000000000000001
100000000000000000000000001
111111111111111111111111111
