NO ./textures/wall_4.png
SO ./textures/wall_3.png
WE ./textures/wall_1.png
EA ./textures/wall_2.png

F 10,0,18
C 11,0,40

                11111
                10S01
                13041                                   11111111111111
                11011111111111111                       1100000F000001
                100000000000000011111111111111111111111111010010010011
                101000001000001000000000000000000000000F00000000000001
                1010000F100000100000F0000000000000000000000000000000F1
                100000000000000011111111111111111001111111111111011111
                10001001010010001               1001           101
                10000F00000000641               1001           101111111111111111
                10101010001010101               1001           100F00000000000001
                10F00000007400001           111110011111       111111111111111101
                10001000100100001           1F00000000F1                      101
                10000000000000001           100000000001                      1011111
                1010000010000168111111111111100018010001111111111111111111111110110F111
                10000000F000000000000800000000000000000000900000000000000600000000000P1
                1111101111110111111111111111100010910001111111111111111111111110110F111
                    101    101              110000000011                      1011111
                11111011111101111           1F00000000F1                      1001
                10000000000000001           111110011111                      1001
                10107600100000101               1001                          1001
                100000000000000011111111111111111001111111111111111111111111111001
                1000100010001000000000000059000000000000000000000000000000000000F1
                100000000000000011111111111111111111111111111111100011111111111111
                10101010001010101                             1100011
                10000000000000001                            1100011
                10001000100100001                           1100011
                10000000000090001                          11F0011
                10100000100001001111111111111             1100411
                10F00000000000000F00000000001            1100911
                11111111111111111111111111111     111   1100011
                                                 11P1111100011
                                        111111111100000000011
11111111111111111                       11000000000001111111
1F0000000000000011111111111111111111111111010010010011
101000001360001000000000000000000000000000000000000001
100000000000000011111111111111111001111111111111011111
10005000000000001               1001           101
10000000000000001               1001           1011111111111111111
100F000000000F001               1001           10000000400000000F1
10000000000000001           111110011111       1111111111111111001
10001000100100001           100000000001                      1001
10000000000090001           190000000001                      1001
1010000010000100111111111111100010010001111111111111111111111110111111111111111111111111111
10000000F000000000000000000000009480000000000000000000000F000000000000000000000000000000001
10000000000000000000000000000000000000000000000000000000000000000000000000000F0000000000001
1111101111111111111111111111100010010001111111111111111111111110011111111111111111111111111
    101                     1000F00F0001                      1001
11111011111111111           100000000001                      1001
10000000000000001           111110011111                      1801
10100000100000101               1001                          1001
100000460000000011111111111111111001111111111111111111111111111001
10001000100010000000000004000000000000000F000000000000000700000001
1000F0000000000011111111111111111111111111111111111111111111111111
10101010001010101
1000000000F000001                                         1111
10001000100100001                                         1P01
10000000000000001111111111111111111111111111111111111111111001
10100000106801000000000000000000037F00000000000000000000000001
10F00000000000000000000000000000000000000000000000000000111111
111111111111111111111111111111111111111111111111111111111
                                                        1111
                                                        10P1
                                                        10011111111111
                11111111111111111                       10000000000001
                100000000000000011111111111111111111111111010010010011
                101000001000001000000000000000000000000000000000000071
                100000000500000011111111111111111001111111111111011111
                10000000000000001               1001           101
                100000F0000000001               1001           1011111111111111111
                10000000000000001               1001           10000000000000F0001
                10000000000000001           111110011111       1111111111111111001
                10001000100100001           100000000001                      1001
                10000006F00000001           100000000001                      1001
                100000000000000011111111111110001001000111111111111111111111111001
                10000000000000000000000000000000000000000F000000000000000000000001
                111110111111111111111111111110001001000111111111111111111111111001
                    101                     100005310001                      1001
                11111011111111111           100000000001                      1001
                100000F0000000001           111110011111                      1001
                10000000000000001               1001                          1001
                100000000000000011111111111111111001111111111111111111111111111001
                100010001000100000000000000000000000000000000000000000000000000001
                1000F0000000000011111111111111111111111111111111111111111111100001
                10000000001010101                                           100001
                10000000000000001                                           10P001
                10001000000000001                                           111111
                10000000000000001
                16000000000000001111111111111
                1800000000000000F000000000051
                11111111111111111111111111111

                                        11111111111111
11111111111111111                       11F000000000F1
100000000000000011111111111111111111111111010010010011
101000001000001000000000000000000000000000000000000001
100000000000000011111111111111111001111111111111011111
10000000000000001               1001           101
100F0000000000001               1001           101111111111111111
100000840000F0001               1001           1000000F0000000001
10000000000000001           111110011111       111111111111111101
10001000100100001           10030000F001                      101
10000000000000001           100000000001                      101
10000000000000001111111111111000100100011111111111111111111111101111111111111111111111111111111111111111111111111111111111111111111111111111111111111111111111111111111
10000000000000000000000000000000000000000000000000000000000000000000000000000000000000000000000000000370000000000000000000000000000000000000000000000000000000000000021
11111011111111111111111111111000100100011111111111111111111111101111111111111111111100111111111111111111111111111111111111111111111111111111111111111111111111111111111
    101                     100540000001                      10F1                 1001
11111011111111111           100000000001                      1001         111111111001
10000000000000001           111110011111                      1001         1F0000000001
10000000000000001               1001                          1001         100173000001
100000000000F00011111111111111111001111111111111111111111111111001         100111111111
10001746010001000000000000000000000F0000000000000000000000000000011111111111F01
10001000100010000000000000000000000000000000000000000F0000000000000000000000001
10000000F000000011111111111111111111111111111111111111111111111111F000000008441
10000001100000001                                                11111111111111
10000000000000001
10001000100100001
1000000F000000001
10000741100000001
10000000000000001
11111110001111111
      10P01
      11111